1
1
1
7
7
11
###########
|     |   |
| ### |#| |
| |   | | |
| ##### | |
|         |
###########